REB = "setup/countries/rebels.txt"
PIR = "setup/countries/pirates.txt"
BAR = "setup/countries/barbarians.txt"
MER = "setup/countries/mercenaries.txt"

# CHINA
TNG = "setup/countries/east_asia/tang.txt"
BLH ="setup/countries/east_asia/balhae.txt"
LUL = "setup/countries/east_asia/lulong.txt"
CHD = "setup/countries/east_asia/chengde.txt"
WBO = "setup/countries/east_asia/weibo.txt"
GYI = "setup/countries/east_asia/guiyi.txt"
NZH = "setup/countries/east_asia/nanzhao.txt"
SHZ = "setup/countries/east_asia/shizou.txt"
MUG = "setup/countries/east_asia/mu'ege.txt"
BDE = "setup/countries/east_asia/badedian.txt"
LUO = "setup/countries/east_asia/luoshi.txt"
LUD = "setup/countries/east_asia/luodian.txt"
YUS = "setup/countries/east_asia/yushi.txt"
BAS = "setup/countries/east_asia/baise.txt"
LOK = "setup/countries/east_asia/lo.txt"
JNG = "setup/countries/east_asia/jinghai.txt"

# TIBET
GUG = "setup/countries/central_asia/guge.txt"
UKT = "setup/countries/central_asia/u.txt"

# STEPPE
QOC = "setup/countries/central_asia/qocho.txt"
KHO = "setup/countries/central_asia/867_khotan.txt"
KIT = "setup/countries/central_asia/khitan.txt"
TAT = "setup/countries/central_asia/tatar.txt"
KRT = "setup/countries/central_asia/keriat.txt"
URK = "setup/countries/central_asia/uriankhai.txt"
QAY = "setup/countries/central_asia/qay.txt"
MON = "setup/countries/central_asia/mongol.txt"
